            NO ./textures/north.png
SO ./textures/south.png
EA ./textures/east.png
WE ./textures/west.png

F 5,65,9
C 0,255,200

1111111111111111
1000000000101001
10000000000S0001
1000000000000001
1000000000000001
1111111111111111
