NO ./textures/bluestone.png
SO ./textures/colorstone.png
WE ./textures/greystone.png
EA ./textures/redbrick.png

C 0,25,20
F 0,0,0

                        11111111111
                        10000000001
                        10000000001
                        10000000001
11111111111111111111111110000000001
100N0000000000000000000000000000001
10001111110011111111111111000000001
10001    10000000000000000111111111
10001    111111111111111001                        1111111111111
100011111100000000000000001                        1000000000001
10000000000011111111111111111111111111111          1000000000001
10000000000000000000000000000000000000001          1000000000001
1000000000000000000000000000000000000000111111111110000000000001
1000000000001111111111111111100000000000000000000000000000000001
1000000000001               100000000000000000000000000000000001
1111111111111               111111111111111111111111111111111111