NO ./textures/north.png
SO ./textures/south.png
EA ./textures/east.png
WE ./textures/west.png

C 8,34,3
F 67,57,97

                        111111111111
                        100000000001
                        100000000001
                        100000000001
111111111111111111111111100000000001
100000000000000000000000000000000001                     1
100011111111111111111111111111111111                    101
10001                                                  10001
10001                                                 1000001
100011111                                            100000001
1000100001                  1111111111111           10000000001
1000000001                  1000000000001          1000000000001
1000100001                  1000000000001111111111100000000000001
100011111111111111          100000000000D000000000D00000000000001
100011000000000001          1000000000001111111111100000000000001
100011000000000001          1000000000001          1000000000001
10001100000000000111111111111000000000001           10000000001
10001100000000000D0000000000D000011111111            100000001
1000110000000000011111111111111D11                    1000001
10100D000000000001           10001                     10001
10000100000N000001           10001                      101
10000D000000000001           10001                       1
100001000000000001           10001
100011000000000001           10001
100011000000000001           10001
100011000000000001          10001
100011000000000001         10001
11D111111111111111        10001
10001                    10001
10001           1111111 10001
1001          11000000010001
101         1100000000000011
101        10000000000000001
101       1000000000000000001
101111111100000000000000000001
100000000000000000000000000001
111111111100000000000000000001
          1000000000000000001
           10000000000000001
            110000000000011
              11000000011
                1111111
